################
#####       ####
#####   P   ####
## ##@      ####
##  ###### #####
###  @  ##@#####
### ### ## #####
### ###  @ #####
### ###### #####
###  @   @######
### ##### ######
###  @ ##@######
### ##### ######
### ##### ######
###  @   @######
################